Hedge Maze
220 230 200
50 100 45
spawns
0 4 21 4 
obstacles
1 1  1 1
2 1  1 1
3 1  1 1
4 1  1 1
5 1  1 1
6 1  1 1
7 1  1 1
8 1  1 1
9 1  1 1
10 1  1 1
11 1  1 1
12 1  1 1
13 1  1 1
14 1  1 1
15 1  1 1
16 1  1 1
17 1  1 1
18 1  1 1
19 1  1 1
20 1  1 1
1 15  1 1
2 15  1 1
3 15  1 1
4 15  1 1
5 15  1 1
6 15  1 1
7 15  1 1
8 15  1 1
9 15  1 1
10 15  1 1
11 15  1 1
12 15  1 1
13 15  1 1
14 15  1 1
15 15  1 1
16 15  1 1
17 15  1 1
18 15  1 1
19 15  1 1
20 15  1 1
1 2  1 1
1 3  1 1
1 14  1 1
1 13  1 1
1 12  1 1
1 11  1 1
1 10  1 1
1 9  1 1
1 8  1 1
1 7  1 1
1 6  1 1
1 5  1 1
20 2  1 1
20 3  1 1
20 14  1 1
20 13  1 1
5 2  1 1
5 3  1 1
5 4  1 1
5 5  1 1
5 6  1 1
5 7  1 1
5 8  1 1
5 9  1 1
5 10  1 1
5 11  1 1
6 11  1 1
6 10  1 1
6 9  1 1
6 8  1 1
6 7  1 1
6 6  1 1
6 5  1 1
6 4  1 1
6 3  1 1
6 2  1 1
10 14  1 1
10 13  1 1
10 12  1 1
10 11  1 1
10 10  1 1
10 9  1 1
10 8  1 1
10 7  1 1
10 6  1 1
10 5  1 1
11 5  1 1
11 6  1 1
11 7  1 1
11 8  1 1
11 9  1 1
11 10  1 1
11 14  1 1
11 13  1 1
11 12  1 1
11 11  1 1
15 9  1 1
15 8  1 1
15 7  1 1
15 6  1 1
15 5  1 1
15 4  1 1
15 3  1 1
15 2  1 1
16 2  1 1
16 3  1 1
16 4  1 1
16 5  1 1
16 6  1 1
16 7  1 1
16 8  1 1
16 9  1 1
16 10  1 1
16 11  1 1
15 11  1 1
15 10  1 1
20 12  1 1
20 11  1 1
20 10  1 1
20 9  1 1
20 8  1 1
20 7  1 1
20 6  1 1
20 5  1 1
