Cave
180 165 150
20 16 15
spawns
0 8 21 7
obstacles
12 6  1 1
16 5  1 1
12 5  1 1
11 5  1 1
8 5  1 1
7 5  1 1
4 5  1 1
3 5  1 1
8 10  1 1
9 10  1 1
8 11  1 1
15 5  1 1
3 11  1 1
4 11  1 1
2 5  1 1
1 5  1 1
5 5  1 1
6 5  1 1
13 5  1 1
14 5  1 1
14 11  1 1
10 11  1 1
9 11  1 1
6 11  1 1
5 11  1 1
2 11  1 1
1 11  1 1
13 11  1 1
1 4  1 1
2 4  1 1
3 4  1 1
4 4  1 1
5 4  1 1
6 4  1 1
7 4  1 1
8 4  1 1
9 4  1 1
10 4  1 1
11 4  1 1
12 4  1 1
13 4  1 1
14 4  1 1
15 4  1 1
16 4  1 1
17 4  1 1
18 4  1 1
20 3  1 1
19 3  1 1
17 3  1 1
16 3  1 1
14 3  1 1
12 3  1 1
11 3  1 1
9 3  1 1
7 3  1 1
6 3  1 1
5 3  1 1
3 3  1 1
2 3  1 1
1 3  1 1
4 3  1 1
8 3  1 1
10 3  1 1
13 2  1 1
14 2  1 1
15 2  1 1
16 2  1 1
17 2  1 1
18 2  1 1
19 2  1 1
20 2  1 1
18 3  1 1
15 3  1 1
13 3  1 1
2 2  1 1
1 2  1 1
1 1  1 1
2 1  1 1
3 1  1 1
4 1  1 1
5 1  1 1
6 1  1 1
7 1  1 1
8 1  1 1
9 1  1 1
10 1  1 1
11 1  1 1
12 1  1 1
13 1  1 1
14 1  1 1
15 1  1 1
16 1  1 1
17 1  1 1
18 1  1 1
19 1  1 1
20 1  1 1
12 2  1 1
11 2  1 1
10 2  1 1
9 2  1 1
8 2  1 1
7 2  1 1
6 2  1 1
5 2  1 1
4 2  1 1
3 2  1 1
1 12  1 1
2 12  1 1
3 12  1 1
4 12  1 1
5 12  1 1
6 12  1 1
7 12  1 1
9 12  1 1
10 12  1 1
11 12  1 1
12 12  1 1
13 12  1 1
14 12  1 1
15 12  1 1
16 12  1 1
17 12  1 1
18 12  1 1
8 12  1 1
7 13  1 1
6 13  1 1
5 13  1 1
4 13  1 1
3 13  1 1
2 13  1 1
1 13  1 1
1 14  1 1
2 14  1 1
3 14  1 1
4 14  1 1
5 14  1 1
6 14  1 1
7 14  1 1
8 14  1 1
9 14  1 1
10 14  1 1
10 13  1 1
9 13  1 1
8 13  1 1
11 13  1 1
12 13  1 1
13 13  1 1
14 13  1 1
15 13  1 1
16 13  1 1
17 13  1 1
18 13  1 1
19 13  1 1
20 13  1 1
20 14  1 1
19 14  1 1
18 14  1 1
17 14  1 1
16 14  1 1
15 14  1 1
14 14  1 1
13 14  1 1
12 14  1 1
11 14  1 1
6 15  1 1
5 15  1 1
4 15  1 1
3 15  1 1
2 15  1 1
1 15  1 1
7 15  1 1
8 15  1 1
9 15  1 1
10 15  1 1
11 15  1 1
12 15  1 1
13 15  1 1
14 15  1 1
15 15  1 1
16 15  1 1
17 15  1 1
18 15  1 1
19 15  1 1
20 15  1 1
3 6  1 1
4 10  1 1
7 6  1 1
8 6  1 1
7 11  1 1
5 10  1 1
6 6  1 1
5 6  1 1
11 11  1 1
15 10  1 1
16 10  1 1
17 10  1 1
18 10  1 1
19 11  1 1
20 11  1 1
15 11  1 1
16 11  1 1
17 11  1 1
19 12  1 1
20 12  1 1
18 11  1 1
4 6  1 1
9 5  1 1
17 5  1 1
19 4  1 1
21 0  1 1
