Shipping Lanes
190 220 225
175 120 80
spawns
0 2 21 4 
0 14 21 12 
21 8 0 8 
obstacles
2 6  1 1
2 10  1 1
19 6  1 1
20 6  1 1
19 10  1 1
20 10  1 1
3 6  1 1
3 10  1 1
18 10  1 1
18 6  1 1
6 6  1 1
7 6  1 1
6 10  1 1
7 10  1 1
10 6  1 1
11 6  1 1
10 10  1 1
11 10  1 1
14 6  1 1
15 6  1 1
14 10  1 1
15 10  1 1
5 1  1 1
6 1  1 1
7 1  1 1
8 1  1 1
9 1  1 1
10 1  1 1
11 1  1 1
12 1  1 1
13 1  1 1
14 1  1 1
15 1  1 1
16 1  1 1
5 15  1 1
6 15  1 1
7 15  1 1
8 15  1 1
9 15  1 1
10 15  1 1
11 15  1 1
12 15  1 1
14 15  1 1
15 15  1 1
16 15  1 1
13 15  1 1
17 15  1 1
18 15  1 1
19 15  1 1
20 15  1 1
20 14  1 1
19 14  1 1
18 14  1 1
17 1  1 1
18 1  1 1
19 1  1 1
20 1  1 1
20 2  1 1
19 2  1 1
18 2  1 1
1 6  1 1
1 10  1 1
