Shipping Lanes
190 220 225
140 110 70
spawns
0 4 21 4
21 8 0 8
0 12 21 12
obstacles
1 1 20 1
1 15 20 1
1 6 5 1
1 10 5 1
16 6 5 1
16 10 5 1
1 2 2 1
1 14 2 1
19 2 2 1
19 14 2 1
