Last Stand
220 225 200
125 105 92
spawns
0 12 5 3 
8 16 8 5 
13 16 13 5 
21 12 16 3 
obstacles
4 1  1 1
4 2  1 1
4 4  1 1
5 5  1 1
6 5  1 1
7 6  1 1
10 6  1 1
11 6  1 1
12 6  1 1
17 1  1 1
17 2  1 1
17 4  1 1
16 5  1 1
15 5  1 1
14 6  1 1
10 4  1 1
10 5  1 1
11 5  1 1
11 4  1 1
12 4  1 1
12 5  1 1
14 4  1 1
15 4  1 1
16 4  1 1
16 1  1 1
15 1  1 1
15 2  1 1
14 2  1 1
14 1  1 1
13 2  1 1
12 3  1 1
11 3  1 1
10 3  1 1
9 3  1 1
7 4  1 1
7 5  1 1
6 4  1 1
5 4  1 1
5 1  1 1
6 1  1 1
7 1  1 1
8 1  1 1
9 1  1 1
10 1  1 1
11 1  1 1
12 1  1 1
13 1  1 1
12 2  1 1
11 2  1 1
10 2  1 1
9 2  1 1
8 2  1 1
7 2  1 1
6 2  1 1
1 13  1 1
1 14  1 1
1 15  1 1
7 15  1 1
6 15  1 1
5 15  1 1
4 15  1 1
3 15  1 1
2 15  1 1
10 15  1 1
11 15  1 1
12 15  1 1
14 15  1 1
15 15  1 1
16 15  1 1
17 15  1 1
18 15  1 1
19 15  1 1
20 15  1 1
20 14  1 1
20 13  1 1
20 11  1 1
1 11  1 1
3 1  1 1
3 2  1 1
18 1  1 1
18 2  1 1
15 6  1 1
6 6  1 1
5 2  1 1
14 5  1 1
16 2  1 1
9 4  1 1
9 5  1 1
9 6  1 1
9 15  1 1
8 3  1 1
13 3  1 1
7 3  1 1
6 3  1 1
8 4  1 1
13 4  1 1
14 3  1 1
15 3  1 1
4 5  1 1
5 6  1 1
16 6  1 1
17 5  1 1
18 4  1 1
3 4  1 1
6 7  1 1
7 7  1 1
10 7  1 1
11 7  1 1
14 7  1 1
15 7  1 1
9 7  1 1
12 7  1 1
2 2  1 1
2 1  1 1
19 1  1 1
19 2  1 1
