MAP NAME HERE
220 230 220
40 40 40
spawns
4 0 17 16 
4 16 17 0 
obstacles
1 1  1 1
1 3  1 1
1 4  1 1
1 5  1 1
1 2  1 1
1 6  1 1
1 7  1 1
1 8  1 1
1 9  1 1
1 10  1 1
1 11  1 1
1 12  1 1
1 13  1 1
1 14  1 1
1 15  1 1
7 1  1 1
8 1  1 1
9 1  1 1
10 1  1 1
11 1  1 1
12 1  1 1
13 1  1 1
14 1  1 1
20 1  1 1
20 2  1 1
20 3  1 1
20 4  1 1
20 5  1 1
20 6  1 1
20 7  1 1
20 8  1 1
20 9  1 1
20 10  1 1
20 11  1 1
20 12  1 1
20 13  1 1
20 14  1 1
20 15  1 1
14 15  1 1
13 15  1 1
12 15  1 1
11 15  1 1
10 15  1 1
9 15  1 1
8 15  1 1
7 15  1 1
13 2  1 1
12 2  1 1
11 2  1 1
10 2  1 1
9 2  1 1
8 2  1 1
9 3  1 1
10 3  1 1
11 3  1 1
12 3  1 1
10 4  1 1
11 4  1 1
8 14  1 1
9 14  1 1
10 14  1 1
11 14  1 1
12 14  1 1
13 14  1 1
9 13  1 1
10 13  1 1
11 13  1 1
12 13  1 1
10 12  1 1
11 12  1 1
2 4  1 1
2 5  1 1
2 6  1 1
2 7  1 1
2 8  1 1
2 9  1 1
2 10  1 1
2 11  1 1
2 12  1 1
19 4  1 1
19 5  1 1
19 6  1 1
19 7  1 1
19 8  1 1
19 9  1 1
19 10  1 1
19 11  1 1
19 12  1 1
3 5  1 1
3 6  1 1
3 7  1 1
3 8  1 1
3 9  1 1
3 10  1 1
3 11  1 1
4 6  1 1
4 7  1 1
4 8  1 1
4 9  1 1
4 10  1 1
5 7  1 1
5 8  1 1
5 9  1 1
6 8  1 1
18 5  1 1
18 6  1 1
18 7  1 1
18 8  1 1
18 9  1 1
18 10  1 1
18 11  1 1
17 6  1 1
17 7  1 1
17 8  1 1
17 9  1 1
17 10  1 1
16 7  1 1
16 8  1 1
16 9  1 1
15 8  1 1
2 3  1 1
3 4  1 1
4 5  1 1
5 6  1 1
6 7  1 1
7 8  1 1
6 9  1 1
5 10  1 1
4 11  1 1
3 12  1 1
2 13  1 1
19 3  1 1
18 4  1 1
17 5  1 1
16 6  1 1
15 7  1 1
14 8  1 1
15 9  1 1
16 10  1 1
17 11  1 1
18 12  1 1
19 13  1 1
14 7  1 1
14 9  1 1
7 7  1 1
7 9  1 1
